00000000000000000000000000000000000000000000000000000000000
02000000002000000000022222022020000000020000000000222220220
02200222222002222000011112221022002222220022220000111122210
01200211211002112022202221210012002112110021120222022212100
00222200222002202021202120200002222002220022020212021202000
00111100112001202220222022200001111001120012022202220222000
00000002222022201110121011100000000022220222011101210111000
00222002111021102220022222200222220021110211022200222222000
00212222022220022120011111200212122220222200221200111112000
00201111021110021022000222200202011110211100210220002222000
00222000020002220012000211122202220000200022200120002111000
00112222220002112202222200021101122222200021100022222000000
00001211110222022201111122220222211111100020000011111000000
00022200000211221222222221110211222000000022220000022200000
00011102222200210111111110000202112222222211120220021220000
02202022111100222222222222000X02002111111220020220020022000
01201021000000111111111112200022022000000120022222220022220
00202222222222222222222002200221021022222220012111110011210
02222221111111111222111001220210020021111110022000022200200
01111110000000000112000000120220022220000000021000221202200
00000000000022222222000022222122011122220000022200210222100
00022220000021111111000021112012000011120000011200222111000
00021222222220000000000022201002222220020000000222212000000
00220111111110000222000011202221121122222220000111102200000
00210000000000000212222222202222020011111120000222201200000
00222220000000222202111112101212022220222222200211200200000
00111120222000211102222002222202222120211211200200222200000
00000020212022200001112001112201111022202200222200111100000
00000022202221100000002222222200000011102100111100000000000
00000000000000000000000000000000000000000000000000000000000